1111111111111111111111111111111111111111
1CCCCCCCCCCCCCCCCCCCCCCCCCCCCCCCCCCCCCE1
1CCC11CCCCCCCCCCCCCCCCCCCCCCCCCCCC11CCC1
1CCCCCCCCCCCCC11111CC11111CCCCCCCCCCCCC1
1CCCCCCCCCCCCC1CCCCCC1CCCCCCCCCCCCCCCCC1
1CCCCCCCC1CCCC111CCCC11111CCCC1CCCCCCCC1
1CCCCCCCCCCCCC1CCCCCCCCCC1CCCCCCCCCCCCC1
1CCCCCCCCCCCCC1CCCCCC11111CCCCCCCCCCCCC1
1CCC111CCCCCCCCCCCCCCCCCCCCCCCCCC111CCC1
1PCCCCCCCCCCCCCCCCCCCCCCCCCCCCCCCCCCCCC1
1111111111111111111111111111111111111111